僞	偽
兌	兑
叄	叁
只	只
啓	啓
喫	吃
囪	囱
妝	妝
媼	媪
嬀	媯
悅	悦
慍	愠
戶	户
挩	捝
搵	揾
擡	抬
敓	敚
敘	敍
柺	枴
梲	棁
棱	稜
榲	榅
檯	枱
氳	氲
涗	涚
溫	温
溼	濕
潙	溈
潨	潀
熅	煴
爲	為
癡	痴
皁	皂
祕	秘
稅	税
竈	灶
糉	粽
縕	緼
纔	才
脣	唇
脫	脱
膃	腽
臥	卧
臺	台
菸	煙
蒕	蒀
蔥	葱
蔿	蒍
蘊	藴
蛻	蜕
衆	眾
衛	衞
覈	核
說	説
踊	踴
轀	輼
醞	醖
鉢	缽
鉤	鈎
銳	鋭
鍼	針
閱	閲
鰮	鰛
一口吃個	一口喫個
一口吃成	一口喫成
介胄	介冑
免胄	免冑
冠胄	冠冑
南涌	南涌
吃口	喫口
吃吃	喫喫
吃子	喫子
壓胄子	壓冑子
大欖涌	大欖涌
大涌	大涌
懸胄	懸冑
東涌	東涌
沙魚涌	沙魚涌
河涌	河涌
泥涌	泥涌
涌尾	涌尾
深涌	深涌
溪涌	溪涌
甲胄	甲冑
胄甲	冑甲
胄科	冑科
葵涌	葵涌
蠔涌	蠔涌
西涌	西涌
貝胄	貝冑
鎧胄	鎧冑
韓侂胄	韓侂冑
飮胄	飮冑
魚胄	魚冑
鰂魚涌	鰂魚涌
麻涌	麻涌
黎涌	黎涌